1111111111111111111111111
10000000000C000000M0C0001
10E00000000000M0000010001
100000010C000M0000C000101
100C00000M000000C00010001
1000000010000C00000000001
1000P0000000100100M00C001
1111111111111111111111111